00 00 00 00 00 00 00 00 00 00 00 00 00 00 00 00
00 00 00 24 25 00 12 14 14 14 13 00 16 17 00 00
00 00 00 23 26 12 11 01 01 01 10 13 15 18 00 00
00 00 00 00 12 11 01 05 04 03 01 10 13 00 00 00
00 00 00 12 11 01 05 06 02 07 03 01 10 13 00 00
00 00 12 11 01 05 06 00 02 02 07 03 01 10 13 00
00 00 09 01 05 06 02 02 00 00 02 07 03 01 08 00
00 00 09 01 08 00 00 00 02 00 00 02 09 01 08 00
00 00 09 01 10 13 02 00 00 02 00 12 11 01 08 00
00 00 07 03 01 10 13 02 00 02 12 11 01 05 06 00
00 00 00 07 03 01 10 13 02 12 11 01 05 06 00 00
00 00 00 00 07 03 01 10 14 11 01 05 06 00 00 00
00 00 00 20 21 07 03 01 01 01 05 06 28 29 00 00
00 00 00 19 22 00 07 04 04 04 06 00 27 30 00 00
00 00 00 00 00 00 00 00 00 00 00 00 00 00 00 00





